7 7 7 7 4 12 12 12 12 12 12 12 12 12 12 12 12 12 12 5 
7 7 7 7 8 1 2 2 2 2 2 2 2 2 2 2 2 2 3 6 
7 7 7 7 8 6 7 7 7 7 7 7 7 7 7 7 7 7 8 6 
7 7 7 7 8 6 7 7 7 7 7 7 7 7 7 7 7 7 8 6 
7 7 7 7 8 6 7 7 7 7 7 7 7 7 7 7 7 7 8 6 
7 7 7 7 8 6 7 7 7 4 12 12 12 12 12 12 12 12 13 6 
7 7 7 7 8 6 7 7 7 8 1 2 2 2 2 2 2 2 2 10 
7 7 7 7 8 6 7 7 7 8 6 7 7 7 7 7 7 7 7 7 
7 7 7 7 8 6 7 7 7 8 6 7 7 7 7 7 7 7 7 7 
7 7 7 7 8 6 7 7 7 8 6 7 7 7 7 7 7 7 7 7 
12 12 12 12 13 6 7 7 7 8 11 12 12 12 12 12 12 12 12 12 
2 2 2 2 2 10 7 7 7 9 2 2 2 2 2 2 2 2 2 2